N N N N C X A X X N
C X A X C X A X X N
C X A X C X A A A N
C C C C C X A X X N
C X A X C X A N N N
C X A X C C A C C N
C X A X X X A X X N
A A A A A A A X X N
C X X X X X A N X N
C N N N N X A N X N